###############'''''#############~~~~~~
###############.....############~~~~~~~
###############.....#############~~~~~~
###############.....##########~~~~~~~~~
###############.....///////////////~~~~
###############.....///////////////~~~~
###############.....///////////////~~~~
###############.....##########~~~~~~~~~
###############.....###########~~~~~~~~
###############.....##########~~~~~~~~~
'...................########~~~~~~~~~~~
'...................############~~~~~~~
'...................#############~~~~~~
'...................###########~~~~~~~~
'...................##############~~~~~
###############.....##########~~~~~~~~~
###############.....##########~~~~~~~~~
###############.....############~~~~~~~
###############.....###############~~~~
###############'''''################~~~

