######################################~
###################################~~~~
####################################~~~
#####################################~~
####################################~~~
#################################~~~~~~
##################################~~~~~
################################~~~~~~~
##############################~~~~~~~~~
###############.....########~~~~~~~~~~~
###############.....##########~~~~~~~~~
###############.....############~~~~~~~
###############.....###########~~~~~~~~
###############.....############~~~~~~~
###############.....##########~~~~~~~~~
###############.....##########~~~~~~~~~
###############.....#######~~~~~~~~~~~~
###############.....##########~~~~~~~~~
###############'''''#########~~~~~~~~~~