CCCCCCCCCCCCCCCCCCCCCCCCCCCCC++++++++++
CCCCCCCCCCCCCCCCCCCCCCCCC++++++++++OO++
CCCCCCCCCCCCCCCCCCC++++++O+++++++++++++
CCCCCCCCCCCCC++++++O+++++++++++++++++++
CCCCCCCCCCC++++++++++++++++++++++++++++
CCCCCCCCCCCCC+++++++OOOO+++++++++++++++
CCCCCCCCCCCC+++++++++++++++++++++++++++
CCCCCCCCCCCCC++++O++++++++++++++++OOO++
CCCCCCCCCC++++++++++++++OO++++O++++++++
CCCCCCCCCCCCCC++++++++++O++++++OO++++++
CCCCCCCCCCC++++++OOOOOO+++++++++++++++'
CCCCCCCCCCCCCC+++++++++++++OO+++++++++'
CCCCCCCCCCCCCCC++++++O++++++O+++++++++'
CCCCCCCCCCCC++++++++++++++++++++++++++'
CCCCCCCCCCC+++++++++++++++++OOO+++++++'
CCCCCCCCCCCCC+++++++++++++++OO+++++++++
CCCCCCCCCCCCCC+++++++++++++++++++++++++
CCCCCCCCCCCC++C+++OO+++++++OOOO++++++++
CCCCCCCCCCCCCCCCCCCCCO++++OOO++++++++++
CCCCCCCCCCCCCCCCCCCCCCCCC++++++++++++++